a=ア
o=オ
e=エ
i=イ
u=ウ
ta=タ
to=ト
te=テ
ti=チ
tu=ツ
tsu=ツ
da=ダ
do=ド
de=デ
di=ヂ
du=ヅ
ka=カ
ko=コ
ke=ケ
ki=キ
ku=ク
ga=ガ
go=ゴ
ge=ゲ
gi=ギ
gu=グ
sa=サ
so=ソ
se=セ
si=シ
su=ス
za=ザ
zo=ゾ
ze=ゼ
zi=ジ
zu=ズ
na=ナ
no=ノ
ne=ネ
ni=ニ
nu=ヌ
ra=ラ
ro=ロ
re=レ
ri=リ
ru=ル
ma=マ
mo=モ
me=メ
mi=ミ
mu=ム
ha=ハ
ho=ホ
he=ヘ
hi=ヒ
hu=フ
ba=バ
bo=ボ
be=ベ
bi=ビ
bu=ブ
pa=パ
po=ポ
pe=ペ
pi=ピ
pu=プ
wa=ワ
wo=ヲ
we=ウェ
wi=ウィ
wu=ウ
fa=ファ
fe=フェ
fi=フィ
fo=フォ
fu=フ
ja=ジャ
jo=ジョ
je=ジェ
ji=ジ
ju=ジュ
cha=チャ
cho=チョ
che=チェ
chi=チ
chu=チュ
tya=チャ
tyo=チョ
tye=チェ
tyi=チィ
tyu=チュ
sya=シャ
syo=ショ
sye=シェ
syi=シ
syu=シュ
sha=シャ
sho=ショ
she=シェ
shi=シ
sho=ショ
kya=キャ
kyo=キョ
kye=キェ
kyi=キュ
kyu=キュ
gya=ギャ
gyo=ギョ
gye=ギェ
gyi=ギィ
gyu=ギュ
hya=ヒャ
hyo=ヒョ
hye=ヒェ
hyi=ヒィ
hyu=ヒュ
bya=ビャ
byo=ビョ
bye=ビェ
byi=ビィ
byu=ビュ
pya=ピャ
pyo=ピョ
pye=ピェ
pyi=ピィ
pyu=ピュ
va=ヴァ
vo=ヴォ
ve=ヴェ
vi=ヴィ
vu=ヴ
wha=ウァ
who=ウォ
whe=ウェ
whi=ウィ
whu=ウ
la=ァ
lo=ォ
le=ェ
li=ィ
lu=ゥ
ltu=ッ
xa=ァ
xo=ォ
xe=ェ
xi=ィ
xu=ゥ
xtu=ッ
tt=ッt
kk=ッk
mm=ッm
rr=ッr
ss=ッs
gg=ッg
dd=ッd
hh=ッh
bb=ッb
pp=ッp
ff=ッf
jj=ッj
yu=ユ
ya=ヤ
yo=ヨ
nn=ン